çıkmaz yol - тупик; глухий кут
türk silahlı kuvvetleri - турецькі збройні сили
gerçekleştirmek - реалізовувати
askeri - військовий (прикметник)
harekat (tı) - військова операція
çerçeve - рамка
çerçevesinde - у рамках, у межах (чогось)
terörist - терорист
helikopter - вертоліт
sayesinde - завдяки (чомусь)
eser - твір (літературний)
kapmak - схопити; вихопити; підхопити (наприклад, вірус)
kör - сліпий
gebermek - здохнути, подохнути
dövmek - (по)бити
sımsıcak - дуже гарячий
uslu - слухняний
arızalanmak - зламатися (наприклад, про машину)
mürekkep (bi) - чорнила
tükenmek - споживатися; закінчуватися (унаслідок споживання)
çizmek - тут: подряпати
üzgün - засмучений, сумний
kabahat (ti) - провина
elinden geleni yapmak - робити все можливе
düşmanca - вороже
kararmak - темнішати
başbaşa - сам на сам
ziyaretçi - відвідувач
resepsiyon - реєстратура, стійка адміністратора (у готелі), "ресепшн"
koyulmak - починати, ставати (до), братися (за, до)
piyes - п'єса
tişört - футболка
kafa - голова
kanıt (tı)д - оказ
taşınmaz mal - нерухоме майно
akıl almaz - неймовірний
çekilmez - нестерпний
topuk (ğı) - підбор, каблук
sahil - узбережжя (морське)
ait - той, що належить
dış i̇şleri bakanlığı - міністерство закордонних справ
yetiştirmek (і) - встигати (наприклад, зробити що-небуть вчасно)
çay - чай
zevk almak (den) - отримувати задоволення
basbayağı, sıradan - середньостатистичний
yardımcı, vekil - заступник
belge, evrak - документ
iş belgeleri - ділові папери
çıkarmak - роздрукувати
belgenin çıktısı - роздруківка документа
yolunu şaşırmak - заблукати
köşebaşı - ріг (вулиці)
baş göstermek - почати спостерігатися, виявитися
değişiklik (ği) - зміна
süt (tü) - молоко
biçimbilim - морфологія
modası geçmiş - вийшла з моди
güvenilmez - ненадійний
halı - килим
(rengi) solmak - потьмяніти, поблякнути
mesaj - повідомлення
kaza yapmak - вчинити аварію
fotoğraf makinesi - фотоапарат
elbise - сукня
yakışmak - личити, бути до лиця
oyuncu - актор
doktordan randevu almak - звернутися до лікаря
ne yaparsın! (ne eylersin!) - що ж поробиш!
müsvedde - чернетка
yanlışları düzeltmek - виправляти помилки
altın - золото
am(m)a,fakat - але
arzu - бажання
ay - місяць
bilet(ti) - квиток
buralı - тутешній
çelik(ği) - сталь, метал
çiçek(ği) - квітка
çizgi - лінія
daire - квартира
dinlenme - відпочинок
ekim - жовтень
göstermek - показувати
gümüş - срібло
hayı́r - добро
işsiz - безробітний
kantin(yemekhane) - їдальня
kat(tı) - поверх
kirli - брудний
not(tu) - оцінка
sakal - борода
sayı - число
şehir(hri) - місто
taş - камінь
uzak - далекий
vişne - вишня
yazı - письмо; лист, текст; усе, що написано
yerli - місцевий
masal - казка
ocak(ğı) - вогнище; родинне вогнище; січень (місяць)
henüz - поки що (не) - у заперечних реченнях
devam etmek(-e) - продовжувати; ходити (до навчального закладу)
boş vakit - вільний час
hep - весь час, постійно
resim çizmek - малювати
hastane - лікарня
daima - постійно, весь час
-in hoşuna gitmek - бути до вподоби
sevimli - милий, приємний
mesken - квартира
araç - машина
hıyar - олух
havlu - рушник
lahana - капуста
gömlek - сорочка
bakan - міністр
kaynana - свекруха
kayınpeder - свекр
salatalık - огірок
yorgan - ковдра
öfkeli - сердитий
demet(ti) - букет
gelin - невістка, наречена
anahtar - ключі
kepçe - ополоник
yaramaz - неслухняний, розбишака
turuncu - помаранчевий
kol - ручка, рука
bayrak - прапор
milletvekili - депутат
karne - щоденник
