كبير - великий
صَغير - маленький
طَويل - довгий
قَصير - короткий
ثَقيل - важкий
خَفيف - легкий
مُمتِع - цікавий
مُمِل - скучний
نَظيف - чистий
وسِح - брудний
عجُوز - старий
شَاب - молодий
جَمِيل - гарний
فَبيح - потворний
غال - дорогий
رَخيص - дешевий
سَعِيد - щасливий
مَسرُور - задоволений
فَرِح - радісний
واسِع - широкий,просторий
شَدِيد - сильний
رانِع - прекрасний
طَيَّب - добрий
جَيَّد - гарний
بَسِيط - легкий
دَقيق - точний
نَيَّر - світлий
حَدِيث - сучасний
نَشِيط - активний
لَزِيز - смачний
دَافِئٌ - теплий
عَزيز - дорогий
عَريض - широкмй
ضَيَّق - вузький
صَعب - важкий(у виконанні)
سَهل - легкий(у виконанні)
قَويّ - сильний
صَعِيف - слабкий
حَسَن - гарний
سَيَّي - поганий
جَدِيد - новий
قَدِيم - старий
كَسلانٌ - ледачий
مُجتهِد - старанний
ساخِن - горячий
بارِد - холодний
عالٍ - високий
مُنخَفِض - низький
