
wise - мудрий
reasonable - розсудливий, поміркований
resourceful - спритний, винахідливий
perceptive - що сприймає, відчуває, розуміє; проникливий
meditative - замислений, споглядальний
imaginative - наділений багатою уявою; який володіє творчою уявою
creative - творчий, креативний
silly - нерозумний; дурний
foolish - дурний,  недоумкуватий
stupid - дурний, безглуздий
half-witted - недоумкуватий, пришелепуватий
brainless - безмозкий, дурний, пустоголовий
dumb - дурний, тупий
accomplished - майстерний, кваліфікований; який отримав хорошу освіту, виховання
educated - освічений; культурний, розвинутий
skilled - досвідчений, умілий, майстерний; кваліфікований
skilful - умілий, майстерний
suave - чемний, ввічливий
polished - вишуканий, елегантний; відточений
refined - витончений, вишуканий, благородний
respectable - поважний, шанобливий респектабельний, пристойний
decent - пристойний, благопристойний, порядний
polite - ввічливий
well-mannered - з гарними манерами
well-bred - добре вихований, ґречний
grateful - вдячний; який висловлює, виражає подяку
thankful - вдячний; задоволений (чимось), що радіє (чомусь)
considerate - уважний, тактовний, дбайливий, турботливий
thoughtful - вдумливий, багатий думками, уважний, турботливий
shy - соромливий, сором’язливий, боязкий, тихий
bashful - сором’язливий; боязкий; скромний
demure - скромний, стриманий
humble - скромний, позбавлений почуття власної гідності, боязкий, простий
modest - скромний, стриманий
timid - сором’язливий, невпевнений, боязкий
cautious - обережний, обачний
prudish - занадто скромний, соромливий; манірний; ґречний; святенницький
brave - хоробрий, сміливий
courageous - сміливий, відважний, хоробрий, безстрашний
adventurous - який любить пригоди,сміливий, небезпечний, ризикований,підприємливий
self-assured - впевнений у собі
self-confident - самовпевнений
vain - марнолюбний; самозакоханий, зарозумілий
materialistic - матеріалістичний
proud - гордий
ambitious - честолюбний, амбітний
show-off - хвалько; кривляка
big-headed - задавакуватий, самовдоволений, самозакоханий
condescending - зверхній; зарозумілий
patronising, patronizing - зверхній; поблажливий (негативне значення)
arrogant - зарозумілий, гордовитий, пихатий, самовпевнений
pompous - пихатий, зарозумілий; пишномовний; помпезний, ефектний
boastful - хвалькуватийй
self-centred - егоїстичний, зайнятий самим собою, егоцентричний
egocentric - егоцентричний
snobbish, snobby - снобістський, чванливий, пихатий
magnanimous - великодушний
generous - щедрий, великодушний, шляхетний
charitable - милосердний, милостивий, благодійний
merciful - милосердний, співчутливий
sympathetic - співчутливий, сповнений співчуття
guilty - винуватий, що відчуває провину
apologetic - той, який просить вибачення; який відчуває, визнає свою провину; який виправдовується
regretful - сповнений жалю, жалості, каяття
greedy - жадібний, зажерливий
selfish - егоїстичний, корисливий
possessive - власницький
jealous - 1) ревнивий2) заздрісний
envious - заздрісний
mercenary - корисливий, продажний
avaricious - жадібний, зажерливий, корисливий
miser - скупій, скнара
outgoing - товариський, дружелюбний, комунікабельний
extravert, extrovert - екстраверт, товариська, дружелюбна людина
easygoing - легкий, невимушений
cordial - сердечний, задушевний; привітний
amiable - люб’язний, доброзичливий, милий, привабливий
genial - ласкавий, привітний, добродушний
affable - привітний; чемний, люб’язний
benevolent - доброзичливий, благодійний, щедрий, великодушний
humane - людяний, гуманний
human - людський, властивий людині
kind-hearted - добрий, добросердий, чуйний
tender - ніжний, м’який, ласкавий, люблячий
tender-hearted - сердечний, добрий, чуйний
warm-hearted - чуйний, співчутливий, добрий, щиросердечний
lenient - м’який, поблажливий; терпимий, лагідний
tolerant - терпимий, такий, що відноситься терпимо
understanding - розуміючий, розумний, чуйний, чуттєвий
liberal - вільнодумний, ліберальний, прогресивний
gentle - м’який, добрий, лагідний, ніжний; тихий, спокійний
sentimental - сентиментальний, чутливий
malicious - злісний, злий,  підступний
spiteful - злобний; недоброзичливий, зловтішний, злопам’ятний; уїдливий
vindictive - мстивий,злопам’ятний
vengeful - мстивий; що мстить
rebellious - непокірливий, неслухняний; бурхливий, буйний
revolutionary - революційний; який викликає крутий злам або корінну перебудову
nasty - неприємний, недоброзичливий
mean - 1) скупий2) злий, підлий
ruthless - безжалісний, немилосердний, жорстокий
heartless - безсердечний, безжалісний, жорстокий
merciless - безжалісний, немилосердний
pitiless - безжалісний; жорстокий
remorseless - безжалісний; що не відчуває докорів сумління
well-known - добре відомий
celebrated - знаменитий, славетний
distinguished - поважний, заслужений, видатний
outstanding - видатний, знаменитий
quiet - спокійний, тихий
calm - спокійний, тихий; мирний, незворушний (про людину)
peaceful - мирний, миролюбний, тихий, спокійний
serene - спокійний, безтурботний; незворушний
equable - урівноважений, спокійний
even-tempered - урівноважений, незворушний
level-headed - спокійний, урівноважений, розважливий, холоднокровний
fair-minded - справедливий, неупереджений
rational - розсудливий, розважливий, раціональний
well-balanced - врівноважений, стійкий, спокійний, стриманий
patient - терплячий, завзятий, наполегливий
relaxed - ненапружений, спокійній, розслаблений
silent - мовчазний, безсловесний, безмовний
reticent - мовчазний, потайливий, стриманий
taciturn - мовчазний, неговіркий
laconic - лаконічний, небагатослівний
reserved - стриманий
talkative - балакучий, говіркий
eloquent - красномовний
loquacious - балакучий, багатослівний
сhatty - балакучий
chatterbox - базіка; пустомеля
garrulous - балакучий
curious - цікавий, допитливий, жадібний до знання
inquisitive - цікавий, допитливий
nosy/ nosey - цікавий, допитливий, пронозливий
tedious - нудний, марудний
tiresome - той, що втомлює, надокучливий
boring - докучливий; нудний
astonished - 1) здивований, вражений
astonishing - 2) дивовижний; гідний подиву, вражаючий
amazed - 1) здивований, вражений
amazing - 2) дивний, разючий; приголомшливий
overwhelmed - 1) переповнений почуттями
overwhelming - 2) непереборний, переважний, подавляючий
exhilarated - веселий, жвавий, бадьорий
excited - схвильований, , жвавий, діяльний
elated - у піднесеному настрої ; у захваті
lively - живий, сповнений життя, веселий, жвавий,
energetic - енергійний, активний
triumphant - переможний, радіючий, торжествуючий, тріумфуючий
frantic - шалений, нестямний, схвильований
thrilled - схвильований, радісний
avid - палкий, завзятий
eager - нетерплячий, охочий, який палко прагне
zealous - завзятий, ревний, старанний; той, хто ставиться з ентузіазмом
ardent - гарячий, запальний палкий, пристрасний; ревний
passionate - пристрасний, палкий
hot-blooded - палкий, жагучий, запальний, гарячий, імпульсивний
excitable - збудливий; який легко збуджується
anxious - стурбований, неспокійний
restless - неспокійний, невгамовний
fussy - метушливий, перебірливий, вередливий
impulsive - імпульсивний, який легко піддається впливу
impetuous - імпульсивний, рвучкий; поспішний
impatient - нетерплячий, роздратований, неспокійний
flustered - дуже збуджений, дуже схвильований
nervous - нервовий, боязкий
insecure - невпевнений
indecisive - нерішучий, невизначений, непевний
sheepish - придуркуватий, боязкий, сором’язливий
frightened - переляканий, наляканий
horrified - нажаханий
coward - боягузливий, легкодухий
determined - рішучий, непохитний
strong-minded - рішучий, цілеспрямований
strong-willed - рішучий, вольовий;  упертий
resolute - твердий, рішучий
obstinate - наполегливий, завзятий; упертий, непіддатливий
stubborn - упертий, непіддатливий
content - задоволений, вдоволений
optimistic - оптимістичний
relieved - той, що відчуває полегшення
blissful - блаженний, щасливий
merry - веселий
jolly - веселий, жвавий, радісний
joyful - радісний, веселий
pleased - задоволений
cheerful - бадьорий, веселий
carefree - безтурботний, нічим не обтяжений
moody - у поганому настрої, сумний, похмурий
gloomy - похмурий, сумний
sullen - похмурий; відлюдний; сердитий; сумний
miserable - нещасний, бідолашний, жалюгідний
melancholic - сумний, меланхолійний
frustrating - 1) який розчаровує, який викликає невіру у свої сили
frustrated - 2) розчарований, який не вірить у свій сили
disappointed - 1) розчарований, зневірений; засмучений 
disappointing - 2) невтішний, який викликає розчарування
bad-tempered - у поганому настрої, злий, дратівливий
temperamental - неврівноважений, імпульсивний
ill-bred - невихований; нечемний, грубий
resentful - обурений, ображений, що приховує злість
edgy - роздратований; нетерплячий; дратівливий
touchy - образливий, уразливий, надто делікатний
a pain (in the neck) - надокучлива людина
irritable - дратівливий; болісно чутливий
cross - сердитий, злий, роздратований
bitter - злий, злютований, розсерджений
hostile - ворожий; неприязний
aggressive - агресивний, задиристий; задирливий, зухвалий
passive-aggressive - пасивно-агресивний
violent - шалений, лютий, запеклий, несамовитий
brutal - жорстокий, звірячий
furious - розлючений, лютий, шалений
enraged - розлючений, розгніваний
exasperated - роздратований, обурений
fair - чесний, справедливий
faithful - вірний, відданий, який заслуговує на довіру
dedicated - відданий
devoted - відданий, ніжний, люблячий, повністю віддається (чому-небудь)
loyal - вірний, відданий,надійний, лояльний
trustworthy - той, що заслуговує довіри, надійний
trusting - довірливий
truthful - правдивий,вірний, правильний
straight - чесний, прямий, щирий, відвертий
straightforward - прямий, безпосередній,  відкритий, відвертий
upright - чесний, справедливий
frank - відвертий, щирий, відкритий
open - відкритий, відвертий, щирий
outspoken - щирий, прямий, відвертий,
sincere - щирий, непідроблений, справжній, істинний
candid - error
artless - простий, щирий, простодушний, наївний
reliable - надійний, певний
loyal adj although they continue to argue - вірний, відданий, надійний, лояльний
dishonest - нечесний, непорядний
disloyal - нелояльний; невірний, віроломний, зрадницький
crooked - нечесний, шахрайський
insincere - нещирий, лицемірний
deceitful - брехливий; віроломний; зрадницький
two-faced - дволикий, лукавий, брехливий
hypocritical - лицемірний, святенницький
unreliable - ненадійний, той, що не заслуговує довіри; недостовірний
treacherous - віроломний, зрадницький,  підступний, облудний;
sly - лукавий, хитрий, пронизливий
cunning - хитрий, лукавий, скритний
artful - хитрий, спритний; підступний
sneaky - потайний, підлий; боягузливий
tricky - хитрий, підступний; спритний; майстерний
crafty - хитрий, вправний, умілий
stealthy - таємний, прихований, злодійкуватий, що робить щось нишком, крадькома
secretive - потайливий, скритний
unscrupulous - недобросовісний; безсовісний, ; нерозбірливий в засобах
disgusted - 1) який відчуває відразу; який виявляє огиду
disgusting - 2) огидний, противний, паскудний
distasteful - огидний, неприємний; образливий
naive - наївний, простодушний, простуватий, недалекий; легковірний
gullible - легковірний, довірливий
impressionable - вразливий, сприйнятливий, чутливий
weak-willed - людина слабкої волі; яка легко піддається сторонньому впливу
critical - осудливий, який критикує; розбірливий, вимогливий
disapproving - який не схвалює, засуджує
demanding - вимогливий
meticulous - дріб’язковий